6	64
32	32
0	1	2	3	4	5	6	7	8	9	10	11	12	13	14	15	16	17	18	19	20	21	22	7	8	23	24	25	26	27	28	29	30	7	8	23	24	31	32	33	20	21	22	7	34	13	14	15	16	17	18	35	36	37	38	39	40	41	24	25	26	27	28	42	
43	44	45	46	47	48	49	50	50	50	51	52	53	54	55	56	57	58	50	59	50	50	60	50	50	61	62	50	50	50	50	63	64	50	50	61	62	65	66	67	50	50	60	50	68	54	50	69	70	50	50	50	71	72	73	74	75	61	62	50	50	50	50	76	
77	78	79	80	81	82	83	50	50	50	84	85	86	50	87	88	89	90	50	50	50	50	50	50	50	50	50	50	50	50	50	91	92	93	94	95	96	97	98	99	50	50	50	50	50	50	50	50	50	50	50	50	100	101	102	103	50	50	50	50	50	50	50	104	
105	106	107	108	109	110	111	50	112	113	114	115	116	50	117	118	117	118	50	50	50	50	50	50	50	50	50	50	50	119	120	121	122	123	124	125	126	127	128	129	130	50	50	50	50	50	50	50	50	50	50	50	131	132	133	134	50	50	50	50	50	119	120	135	
136	137	138	139	140	141	142	143	144	145	146	147	148	50	149	150	151	152	50	50	50	50	50	50	50	50	50	50	50	50	50	153	154	155	156	157	158	159	160	161	50	50	50	50	50	50	50	50	50	50	50	50	162	163	164	165	50	50	50	50	50	50	50	166	
167	168	169	170	171	172	173	174	175	176	177	178	179	180	181	182	183	184	185	186	187	188	189	190	191	192	193	178	179	180	194	195	196	50	197	198	50	199	200	201	191	192	193	178	179	180	194	202	203	204	185	205	206	207	208	190	191	192	193	178	179	180	194	209	
